# This file was saved at Thu Feb 16 2017 15:44:22 GMT+0100 (CET)
# from file:///home/igng/Downloads/robo/mapeditor/index.html

extra:

paint:

map:
AAAAAAAAAAAAAAAAAAAAAAAAAAAAAAAAAAAA
A                                  A
A AAAA AAAAAAAAAAAAAA AAAAAAAAAAAA A
A A          A              A    A A
A A AAAAAAAAAAAAAAAA AAAAAAAAAAA A A
A A A                     A    A A A
A A A AAAAA AAAAAAAAAAAAAAAAAA A A A
A A A A          A           A A A A
A A   A AAAAAAAAAAAAAAAA AAA A A   A
A A A A A                  A A A A A
A A A A A AAAA AAAAAAAAAAA A A A A A
A A A A A A              A A A A A A
A   A A A A AAAAAAAAAAAA A A A   A A
A A A A AAA A    A     A A A A A A A
A A A A A A A AAAAAAAA AAAAA A A A A
A A A A A A A A      A A A A A A   A
A A A A A A A A      A A A A A A A A
A A A A A A A A  **  A A     A A A A
A A A   A   A A  **  A A A A A A A A
A A A A A A A A      A A A A A A A A
A A A A A A A A      A A A A A A A A
A A A A AAA A AAAA AAA   A AAA A A A
A A AAA A A A          A A A A A A A
A A A A   A AAAAAAAAAAAA A A A A A A
A A A A A A              A A A A A A
A A A A A AAAA AAAAAAAAAAA A A A A A
A A A A A               A  A A A   A
A   A A AAAAAAAAAAAAA AAAAAA A   A A
A A A A    A            A      A A A
A A A AA AAAAAAAAAAAAA AAAAAAA A A A
A A A                          A A A
A A AAAAAAAAAAAAAAAAAAAAAAAAAAAA A A
A A      A  A                    A A
A AAAAA AAAAAA AAAAAAAAAAA AAAAAAA A
A                  @               A
AAAAAAAAAAAAAAAAAAAAAAAAAAAAAAAAAAAA